SinCity
An Interactive Fiction by Wendigo
Release 1 / Serial number 150304 / Inform 7 build 6L38 (I6/v6.33 lib 6/12N) SD

City Park
The path along the park has seemed to come to a small clearing. On one side sits a bench with scattered yellow papers strewn across it. A still smoking crater, obviously made by some sort of falling anomaly, is present right behind it.  The anomaly appears to be some sort of chest or case with several doors, one of which is currently open to allow access to the storage compartment within. The open compartment has what appears to be... wooden sticks?

Eerie silence is all that can be heard this deep in the park, and the slight chill in the air makes you feel uneasy just to be here.

A beautiful woman clad in dark stands before you.

Exits: east.

>talk witch
That's not a verb I recognise.

>talk to witch
That's not a verb I recognise.

* * *

>examine The Witch
The Witch is wearing a long robe and carrying a small silver key.

tf text 1.

* * *

>east
Park Entrance
The foreboding darkness of the city park looms here, swallowing up any that dare go inside.  Something seems off about it tonight, and not in a good way.

Exits: west to the City Park and north.

>n
15 Rogers Road
The foreboding darkness of the city park looms here, swallowing up any that dare go inside.  Something seems off about it tonight, and not in a good way.

Exits: south to the Park Entrance and west.

>w
Junkyard
The junkyard seems empty other then sound of the wind blowing.  This shit hole seems like it would be the favorite spot of anything porcine, considering its atrocious smell and amount of mud.. Maybe it's best to watch where you step.

Exits: east to 15 Rogers Road.

* * *

>examine woman
You can't see any such thing.

>examine beautiful woman
You can't see any such thing.

>look woman
You can't see any such thing.

>look witch
The witch is wearing a long robe and carrying a small silver key.

tf text 1.

* * *

>look witch
The witch is wearing a long robe and carrying a small silver key.

As you collapse, unable to resist the retriever girl's assault any longer she approaches you with an expression somewhere between hunger and lust.  You find yourself becoming increasingly aroused as she strips your clothes and gear from your body, intent on reaching the prize underneath. As soon as she has access, the sexy canine starts licking at your cock with her large canine tongue, quickly bringing it to full erection.
Once she's satisfied that you're as ready as she is, the retriever moves to bring her needy slit into position over your erect meat and slowly lowers herself onto you with a whimpering yip. As she raises and lowers herself against you, you find yourself slipping into a lust filled haze, lost in the pleasure this sexy canine is forcing on you. Before long you feel yourself approaching your peak as the retriever quickens her pace, but just before you climax she reaches it first, howling in pleasure as she convulses above you, pushing you over the edge you fill her needy body with your seed.
Afterwards, she collapses atop you, almost as exhausted as you are, the two of you lay there for some time lost in the afterglow of your lovemaking, before she raises herself off your, running her belly contently as she pads away leaving you to recover on your own.
.  As she strips you of your clothing and gear, you see her face overcome with disappointment as she discovers you lack the prize she's looking for. Her expression brightens again a moment later and she dives face-first into your crotch, clearly intent on making sure you're satisfied even if she quite doesn't get what she wanted.
As she drags her wet canine tongue across your feminine slit you can't help but shiver in delight. As her licking and nibbling continues you quickly find yourself approaching climax and as a final push to bring you over the edge the lustful canine drives her muzzle into you, licking at your depths as you scream in pleasure, soaking her muzzle and face in your juices.
Before getting up to leave you canine playmate gives you one last long doggy kiss, giving you a taste of your own juices then leaves you to recover alone, you watch her tail wag happily behind her as she walks away still licking your juices from her muzzle.

* * *

>examine
(the witch)
The witch is wearing a long robe.

As you collapse, unable to resist the retriever girl's assault any longer she approaches you with an expression somewhere between hunger and lustYou find yourself becoming increasingly aroused as she strips your clothes and gear from your body, intent on reaching the prize underneath. As soon as she has access, the sexy canine starts licking at your cock with her large canine tongue, quickly bringing it to full erection.
Once she's satisfied that you're as ready as she is, the retriever moves to bring her needy slit into position over your erect meat and slowly lowers herself onto you with a whimpering yip. As she raises and lowers herself against you, you find yourself slipping into a lust filled haze, lost in the pleasure this sexy canine is forcing on you. Before long you feel yourself approaching your peak as the retriever quickens her pace, but just before you climax she reaches it first, howling in pleasure as she convulses above you, pushing you over the edge you fill her needy body with your seed.
Afterwards, she collapses atop you, almost as exhausted as you are, the two of you lay there for some time lost in the afterglow of your lovemaking, before she raises herself off your, running her belly contently as she pads away leaving you to recover on your own.
As she strips you of your clothing and gear, you see her face overcome with disappointment as she discovers you lack the prize she's looking for. Her expression brightens again a moment later and she dives face-first into your crotch, clearly intent on making sure you're satisfied even if she quite doesn't get what she wanted.
As she drags her wet canine tongue across your feminine slit you can't help but shiver in delight. As her licking and nibbling continues you quickly find yourself approaching climax and as a final push to bring you over the edge the lustful canine drives her muzzle into you, licking at your depths as you scream in pleasure, soaking her muzzle and face in your juices.
Before getting up to leave you canine playmate gives you one last long doggy kiss, giving you a taste of your own juices then leaves you to recover alone, you watch her tail wag happily behind her as she walks away still licking your juices from her muzzle.

* * *

>e
Park Entrance
The foreboding darkness of the city park looms here, swallowing up any that dare go inside.  Something seems off about it tonight, and not in a good way.

Exits: west to the City Park and north.

>n
15 Rogers Road
The foreboding darkness of the city park looms here, swallowing up any that dare go inside.  Something seems off about it tonight, and not in a good way.

Exits: south to the Park Entrance, west, northwest, north and east.

>w
Junkyard
The junkyard seems empty other then sound of the wind blowing.  This shit hole seems like it would be the favorite spot of anything porcine, considering its atrocious smell and amount of mud.. Maybe it's best to watch where you step.

Exits: east to 15 Rogers Road.

>e
15 Rogers Road
The foreboding darkness of the city park looms here, swallowing up any that dare go inside.  Something seems off about it tonight, and not in a good way.

Exits: south to the Park Entrance, west to Junkyard, northwest, north and east.

>e
Dead End
Pretty much just a paved path in the City Park, it seems the construction crew must've just given up and stopped here when making the surrounding area.  Of course... the area all around this kind of serves as proof of the supposed construction crews work ethic.. but who's complaining?

Exits: west to 15 Rogers Road and southeast.

>se
Small Trail
A dark trail, almost completely hidden, spirals in between the overgrowth, your ability to see where it ends being cut short by every bend in its winding path.

Exits: northwest to Dead End and southeast.

>se
Whispering Cave
The brush ends, coming to a gaping hole in a wall of rock.  Some sort of cave it seems, the wind whistling through it... no, not whistling, more whispering.  Creepy.

Exits: northwest to Small Trail and south.

>s
Starting Witches Coven
The apparent Coven definitely seems lived in, as the torches on the walls are lit, and everything seems relatively clean.  "Our Mother Schera, blessed mother of our Coven" is etched above a large statue dominating the opposite wall.  The statue is of a elephant, this... covens apparent favorite animal.

You can see Elephant Statue here.

Exits: north to Whispering Cave.

>examine
What do you want to examine?

>Elephant Statue
You can't see any such thing.

* * *

>s
Starting Witches Coven
The apparent Coven definitely seems lived in, as the torches on the walls are lit, and everything seems relatively clean.  "Our Mother Schera, blessed mother of our Coven" is etched above a large statue dominating the opposite wall.  The statue is of a elephant, this... covens apparent favorite animal.

You can see Elephant Statue here.

Exits: north to Whispering Cave.

>examine Elephant Statue
You see nothing special about Elephant Statue.

As the chanting grows louder, you can feel your body stir unnaturally.  Your penis, seemingly chosing the most annoying time to do so, swells with blood, soon fully erect and pressing against the front of your jeans.
Your shift uncomfortably as your dick pressing harder and harder, making you curse with frustration.  Your only choice is to pull down your pants, yanking your underwear with them to free up... Oh my god.
Your normally average sized, healthy colored dick has changed completely.  It grows more and more, its skin changing to a dark grey, becoming wrinkly despite its massive erection.  "Noo... please" you moan in desperation as your balls swell, close to completing your unwilling transformation into the animal this coven has made their worshipped entity.
The chanting constantly increases in pace and volume, accelerating your change.  Your body grows, a stringy tail dropping out behind you, your shirt ripping off you as you grow bloated and huge.  "Noooeeeeeeerrrfffff" you try to whimper, turning into a bellow as your face sprouts out in front of you, your nose lengthening into trunk and your ears growing mammoth in scale.
You fall on all fours, your mind racing to try to find a way out from ending up as a bull elephant for the rest of your life.  It starts to slow though, thoughts of the warm pussies of beautiful female elephants trickling into your mind, stirring your gigantic elephant phallus.  You gotta stay human, you gottttaaa errrrrrrrfffffffffFFFFFFFFFF your thoughts can't stay togeth-rrr gottta fuucccckk GOTTA FUCKKKKERRRFFFFFFFFF.

I beg your pardon?