The End of the World: TF Series: Witches Coven, a prequel to the original End of the World Twine game. 

by The Loveable Wendigo.

An Interactive Fiction
Create Your Character

Press any key to continue ...

>[down]
It's time to choose what sex you were born as.  You'll be lucky to stay this the course of the game, and even luckier to end it as human.

Please choose a gender for your character.

>m
Thank you. We now begin...

Press any key to continue ...

>[enter]
Ah well how to start.. well this is your head.  Yep, that's right, you.  And you've been living in this city for quite a while.  Of course, there's not much to say about you, as you already know, and are starting to wonder why you are saying all this to yourself in your head. 

Press any key to continue ...

>[enter]
Welp, might as well give yourself a quick summary of the days events if you're gonna be crazy like this.  Hmmm lets think.. well nothing out of the ordinary happened, UNTIL like right now.  Because you chose to work out for once by jogging like a normal out of shape person through the city park, and got lost.  And then something decided to just shoot out of the sky, or appear out of nowhere or something else that makes someone whos still saying this in their head seem even crazier.

Press any key to continue ...

>[enter]
Anyways, the second that dropped out of the sky you could hear stranges noises and cries throughout the city. Which is never a good sign.  Coupled with the horrible uneasy feeling you have had in your stomach since, well... to look at it positively it may have been nice that you got lost in the city park.

Okay, time to get some stuff done, like finding a way out so you can at least see what's happened.  You start at a determined pace again, weaving down the path you SWEAR you've been down before.  The bend up ahead is different though... something is casting flickering light against the nearby trees as you get closer and closer.

Press any key to continue ...

>[enter]
City Park
The path along the park has seemed to come to a small clearing. On one side sits a bench with scattered yellow papers strewn across it. A still smoking crater, obviously made by some sort of falling anomaly, is present right behind it.  The anomaly appears to be some sort of chest or case with several doors, one of which is currently open to allow access to the storage compartment within. The open compartment has what appears to be... wooden sticks?  Or wands... seriously?  Seriously, freaking wands?  Welp, it has been a weird day.  Some bull ran through a china shop today down the road from your work.  Of course, when the cops showed up, they found a whole herd of cattle.  But you crocked that up to it just being the city.

Weird things happen in the city.

Eerie silence is all that can be heard this deep in the park, and the slight chill in the air makes you feel uneasy just to be here.

You can see Fulfill Your Destiny, a wand, a tree, a few bushes, and a streetlight here.

>take wand
You see nothing special about the wand.

Do you pick up the wand?

>u
Please answer yes or no.

* * *

>m
Thank you. We now begin...

Press any key to continue ...

>[down]
Ah well how to start.. well this is your head.  Yep, that's right, you.  And you've been living in this city for quite a while.  Of course, there's not much to say about you, as you already know, and are starting to wonder why you are saying all this to yourself in your head. 

Press any key to continue ...

>[down]
Welp, might as well give yourself a quick summary of the days events if you're gonna be crazy like this.  Hmmm lets think.. well nothing out of the ordinary happened, UNTIL like right now.  Because you chose to work out for once by jogging like a normal out of shape person through the city park, and got lost.  And then something decided to just shoot out of the sky, or appear out of nowhere or something else that makes someone whos still saying this in their head seem even crazier.

Press any key to continue ...

>[down]
Anyways, the second that dropped out of the sky you could hear stranges noises and cries throughout the city. Which is never a good sign.  Coupled with the horrible uneasy feeling you have had in your stomach since, well... to look at it positively it may have been nice that you got lost in the city park.

Okay, time to get some stuff done, like finding a way out so you can at least see what's happened.  You start at a determined pace again, weaving down the path you SWEAR you've been down before.  The bend up ahead is different though... something is casting flickering light against the nearby trees as you get closer and closer.

Press any key to continue ...

>[down]
City Park
The path along the park has seemed to come to a small clearing. On one side sits a bench with scattered yellow papers strewn across it. A still smoking crater, obviously made by some sort of falling anomaly, is present right behind it.  The anomaly appears to be some sort of chest or case with several doors, one of which is currently open to allow access to the storage compartment within. The open compartment has what appears to be... wooden sticks?  Or wands... seriously?  Seriously, freaking wands?  Welp, it has been a weird day.  Some bull ran through a china shop today down the road from your work.  Of course, when the cops showed up, they found a whole herd of cattle.  But you crocked that up to it just being the city.

Weird things happen in the city.

Eerie silence is all that can be heard this deep in the park, and the slight chill in the air makes you feel uneasy just to be here.

You can see Fulfill Your Destiny, a wand, a tree, a few bushes, and a streetlight here.

>n
You can't go that way.

>examine wand
You see nothing special about the wand.

Do you pick up the wand?

>y
You pick up the wand, a strange power tingling down your arm as the end briefly glows.

**BAM**

Before your brain can even process what is happening, a massive explosion of magic happens right in front of you, knocking you to your back with the force.

"INTRUDER, LAY DOWN MY ARTIFACT" the sound, decibels above what any normal human could project, nearly blows your damn ears out.  Figuring she must mean the Wand, you throw it to the ground, raising your hands up after as if you were surrendering.

Press any key to continue ...

>[down]
"INTRUDER, LAY IT DOWN OR FACE MY WRATH" You have no idea how to react, so you do what you've always done best and curl into the fetal position.  The massive sound ceases, and the smoke clears, whisking off to nothingness. 

Press any key to continue ...

>[down]
Still shivering, you peek your eyes out from around your arm.  A woman stands there, clad in dark robes, her features beyond beautiful.

"What is your name, mortal?" the question flows of her lips like notes rippling on a harp. You stutter your name in response, hardly knowing what the hell is happening.

"You have my artifact, young one" she says. "I am the protector of this magical realm, the Mistress of the Dog.  I am one of several who rule this magical realm, among my fellow justicars The Mistress of the Elephant, the Bull, and the Zebra. I have come to despise my sisters though, as being their protector I am always watching over them.. and in the time I have guarded them they have grown restless and violent.

Today is the End Day, the day in which their hate for mankind is spilling over.  You do not know this but you are that which is Chosen, one who carries the Artifact."

**CRACK**

With a snap of her fingers, a box appears in your hands.  "Wha... what is this?" you ask in wonderment.

Press any key to continue ...

>[down]
With a kind smile, she answers "This is the Artifact, child.  It is your kinds only hope in saving your physical world from my sisters and their minions.  You must collect the wands of their covens, place them in the Artifact and then find the ancient device that will remove our world from yours.

"Where is it?!" you cry, beginning to get distressed about her extremely high expectations of you.

Shaking her head she responds "I do not know, none who hold a wand of power can know that".  Well. This is sounding kinda difficult.

Press any key to continue ...

>[down]
"OO! That reminds me!" she says, snapping her fingers again.  The wand you had previously thrown on the ground rises, slowly moving through the air towards you before coming to a stop and hovering a foot from your box.

"Take my wand, The Wand of The Dog, and place it in the box, sealing my magic.  Hurry now! There is not much time! You must find the other three and then dispose of them!" you nod, terrified at the prospect, but still snatch the wand out of the air and throw it in your box.

Looking up, the beautiful witch is smiling at you and fading away into nothingness...

Well, fuck guess you gotta save the world.

>e
(first opening Fulfill Your Destiny)

Park Entrance
The foreboding darkness of the city park looms here, swallowing up any that dare go inside.  Something seems off about it tonight, and not in a good way.

You can see Fulfill Your Destiny, a couple bushes, an entrance sign, a bent fence, and a flickering streetlight here.

Exits: north.

>n
15 Rogers Road
The foreboding darkness of the city park looms here, swallowing up any that dare go inside.  Something seems off about it tonight, and not in a good way.

Exits: south to Park Entrance, west, northwest, north and east.

>w
Junkyard
The junkyard seems empty other then sound of the wind blowing.  This shit hole seems like it would be the favorite spot of anything porcine, considering its atrocious smell and amount of mud.. Maybe it's best to watch where you step.

You can see some trash, a toolbox, and an orange container (empty) here.

Exits: east to 15 Rogers Road and west.

>w
Entrance to Warehouse Row
The industrial quarter of the city is sprawled in front of you, the hundreds of shipping containers weaving around the massive warehouses here.  Most of them connect to the ocean, allowing enormous ships to dock and load up on supplies before heading out into the dark ocean.  Just like the park, it's silent and empty.  There's a few workers that must be here, though, as lights are on in several warehouses and hushed voices can be heard.

Exits: east to Junkyard, west and south.

>w
Ocean Path
Spiraling to the west is a lone path, which begins at a knocked down chain fence and rides the hills along the northern part of the Warehouse Row.  It's path can be somewhat treacherous, as the land changes from concrete structures to mountainous cliffsides.  Who knows where a path like that will lead...

Exits: east to the Entrance to Warehouse Row and northwest.

>w
You can't go that way.

>e
Entrance to Warehouse Row
The industrial quarter of the city is sprawled in front of you, the hundreds of shipping containers weaving around the massive warehouses here.  Most of them connect to the ocean, allowing enormous ships to dock and load up on supplies before heading out into the dark ocean.  Just like the park, it's silent and empty.  There's a few workers that must be here, though, as lights are on in several warehouses and hushed voices can be heard.

Exits: east to Junkyard, west to Ocean Path and south.

>s
AJK Supply Entrance
As you walk into the first warehouse of warehouse row, the sound of barking greets you.  Cages are everywhere, lining every wall with thousands of dogs in them. Looking closer it seems like they are pleading for help, most of them sitting there purposely trying to meet your gaze.

Exits: north to the Entrance to Warehouse Row and south.

>s
Tinman Moving Entrance
Tinman... well that's a creepy name.  You stare up at the enormous foreboding letters on the outside of the warehouse, your mind creating all sorts of terrifying witchrelated acts that can happen to you the second you step in that warehouse.  Jeez, you already spooked yourself.

Exits: north to AJK Supply Entrance, southwest, west and east.

>e
Dark CulDeSac
A portal... or what you can only assume is a portal, as youre kinda new to this whole magic thing.. sits in the middle of the darkened culdesac.  Through the small localized black hole of terrifyingness, you can begin to make out some structures on the other side.  It seems like a bright and happy day there, in some sort of junglelike, perhaps savannahlike, environment.  Looking closer you can see people, dozens of them, standing on the other side of a cage.  Jeez.. what are these witches up to?

You can see Portal (empty) here.

Exits: west to Tinman Moving Entrance.

>enter portal
You get into Portal.

You step through the portal, a slight burning feeling washing across your body as you do.

"Caroline!" A voice yells. "wake up, come on we are putting on the show for Christ sakes".  You look around, flustered and trying to get a sense of your surroundings. "Caroline! Quit daydreaming!" The voice echoes again, this time you can recognize it coming from your right..  You wheel around to see a woman beckoning at what must only be you, as you can now see now the other humans on the other side of bars along the entire clearing to the left.

"Wha? me.. whats wrong with my voice?" you gasp, looking down to see that you have breasts?  Cute little B-cups in a light blue shirt, with jean shorts below, showing off your long tan legs.  You have what looks like a safari hat on and a nametag that says Caroline on it.  Oh fuck. You must've changed places with someone.. obviously a young woman.. when you took the portal.  Your friend, or fellow safari adventurer or whatever was going on, was a few feet away, striding towards you and... SMACK! 

Press any key to continue ...

>[down]
She smacked you across your face, a teasing smile on her lips. "Come on, girl" she said, looking deep in your eyes, "we gotta feed the giraffes, the whole crowd is here to see it...  heh, I think I know what you are thinking about but come on."  She turned after a flirty wink as it all came together in your head.  You must be in some sort of zoo, as one of the zookeepers, and this was definitely your lover?  Definitely.  The way she looked at you.  Sweet!!!! Hot lesbians! you think to yourself, beginning to trudge after her, thinking about her awesome ass.

That's when a few giraffes strode around the corner, to the gasping amusement of the crowd.  Cameras started snapping immediately. Everything must've been fine though, as your lover, whatever her name is, turned around and waved back at the crowd confidently.  You glanced quickly at "Amys" badge just to learn your sexy lesbian lovepieces name in case anything.. happened.

Press any key to continue ...

>[down]
"Caroline!" Amys whisper wakes you from your thoughts of her naked body being at your whim.  "Oh.. uh yeah shit, what we gonna do?" you ask, also trying to keep it at a whisper.  You don't want to start acting like a crazy person in front of a crowd.

Amy looks frustrated by your weird reactions, her pretty face scrunched in a scowl as she retorts "Goddamnit keep your mind on whats at hand.. we gotta give the crowd the show of feeding the dumb beasts, and do damn good job of sneakly injecting the late releasing pheromones in them so we don't have to come back tonight. We've done it a hundred times before, whats wrong with you?"

Press any key to continue ...

>[down]
You look down into your pouch, finding a tiny syringe, labeled GIR-PHER-0316.  "Sorry, I know what we're doing".  You apology was kind of true... you know you're gonna have to inject these giant beasts with this serum, easy easy.  "You feed em I'll inject em" you say.  Amy nods in agreement, fulling a food pouch out of her zookeepers bag.  You pull the serum out, trying to be subtle.  Maybe you can go along with this and you and Amy can have some fun later..

Taking the safety cap off the serum as Amy starts to introduce the crowd to the giraffes through a microphone headset, you walk over near her to the haunch of the first giraffe.  You hardly meet the haunches of the giant slender beast, the impressive height something you had never seen before in an animal.

Press any key to continue ...

>[down]
The giraffe senses your uneasiness.. or maybe something else. Fuck you gotta do this now, Amy is reciting her lines but staring at you with that one scowl.  Grabbing the needle, you pull it back Pulp Fiction style and thrust it forward.  The giraffe makes some sort of bellow in surprise and bucks, smacking your hand and the syrine right out of it... and into Amys shoulder.

"OW FUCK" she yells in response, pulling it out immediately and throwing it to the ground in frustration. "WHAT THE FUCK?!" she yells at you.  But you aren't paying attention.  You are sitting there with your mouth open at the sight of fur sprouting out of her shoulder. "Ugh I feel weird.." she says, rubbing her arm and gasping out loud at the feeling of growing fur.

"NOOO!"

The giraffes scatter, and the crowd is murmuring in confusion.  You are just staring at Amy, trying to apologize, as she starts moaning and holding her stomach.  Her hand moves down to her crouch, and her moans grow deeper as small horns form on her head.  "Caroline I feel sooooo good" she bellows, staring at you in a very.. dominant way.

Press any key to continue ...

>[down]
"Don't worry Amy" is all you can say.  But you don't mean it, you have no idea where you are let alone how to fix this. And HOLY SHIT... you can't believe what you are seeing.  Her former hands (now hooves) frantically fumbling with the area, a massive sheathed giraffe dick explodes out her pants, precum leaking out and falling to the ground.

Amy seems to have forgotten anything else but the need of getting off, her lengthening arms frantically rubbing her new phallus.  You have no idea what to do, but running is sounding good about now.

Right when you think that, Amy leaps forward and shoves you down to your knees. "YOU DID THIS, NOW HELP!" her almost animal demand echoing through your ears.  You try to struggle despite your small frame, but its no use.  Amys almost half bull giraffe by now and sexcrazed, and she holds you down, throbbing dick proding your face.  It finds your pursed female lips, and you try to hold them shut as best you can. 

Press any key to continue ...

>[down]
You can't hold it for long.. you have to do something. You try to get out something to bring her to her senses but she just shoves her giraffe dick in your mouth the instant you open it. "FLFURRRRFFFFFF" is all you can say as she fucks your throat.  Tears stream down your throat as you get face fucked, the tourists just standing in shock.

But then you felt something.  Wetness in your nether regions.  Were you getting turned on?  A earsplitting bellow exploded from Amy as she continued her steady thrusts.  She must be really enjoying the feeling of having a dick, and pounding into your throat.  All you can do is gag and stay there squatting on the ground being raped by your increasingly bull-giraffe lover.  The thought sends a quick tingle of pleasure through the wetness in your pants, the surprise of it allowing a "mmmm" to escape the lips that are tight wrapped around the giraffe cock.

God there it was again.. "MmmmmMMM" you say, confused by the pleasure, but certainly not disliking it.  You couldn't believe that you were getting turned on by the thought of being raped by a giraffe, especially as a woman.. but you couldn't help it. It just felt natural.  You felt your finger exploring the area below you, fumbling for a way into your khakis.  Finding the zipper, you pulled it down, grabbing your panties (and noticing that Caroline was definitely someone who shaved) and pulling them to the side to touch your warm lips.  You had been with a woman before, and it felt much like when you pleasured them with your curious fingers, but this was something else.  You felt like a agent of reproduction, your hands teasing your unknown, unexplored area, causing the natural lube your body was creating to cover your hands, proof of your extreme need.

Your male mind.. hell your human mind.. was struggling and fighting a losing battle.  Unknown to you, the quality of the throat fucking you were getting began to return itself, your lips rubbing and moving with the large cock as you got more into it. You other hand went down to cup your bull giraffe lovers impressive testicles, softly massaging them.  Amy, now almost half a giraffe, and a male one at that, suddenly tensed with the increased encouragement and smell of your attraction.  You could feel the balls shake in your hands with a final thrust as your throat was gifted her massive amount of animal cum, all the way down it and into your stomach.  "Mmmmmm" the sound sneaking out of your mouth again, your attraction to this mate driving you nuts.

Press any key to continue ...

>[down]
The you realized what you just did.  And you fall to ground, disgusted beyond belief at yourself, the thought of the massive amount of giraffe cum sitting in your stomach making you feel queasy.  You try to think what you have to do to get out of this nightmare of lust...

Taking a deep breath you stand up and wheel around, marching across the habitat to what appears to be an exit near the gaping mouthed tourists.  But as you stride, trying to keep yourself composed, your stomach start to growl, a slow soreness spreading from it.  Soon you can hardly walk, stopping to hold your stomach.  That cum may be turning you too, you think in a panic, terrified of the thought of it moving through you, turning you into a female giraffe.  But if that's true that must mean your mouth..

And as if it was right on cue.. your tongue falls out of your mouth.  No, not out, its just draped down, a bluelish color.  Just like the other giraffes, specifically a still changing Amy.  Which, where is she?  Turning around you can see her walking after you still, her body still changing into a dominant fuck machine.

Your stomach gurgles again, bringing the feeling of heat to your loins with it. "Oooooo nooo" you moan, the thought of being pushed over, cheeks spread and fucked like an animal exciting you.  Your pants seem like they hardly fit, and your sexy zookeeper ass, the same ass you definitely did not start the day with, seems to be growing.  The pain your tight pants are causing is unbearable too.  You have to take them off.  "OW OW OWW" you yelp as they split before you even can, wide long hips with tan and white giraffes fur popping out of them.  You start to scream, trying to run away from your imminent change. "NOOOO I don't wanna be a giraffe!" you screamed as your body changes again, a short tail with a small poof of fur on the end extending out of your widening ass.  The cum is changing you, and its changing from the inside... "UGHHH" you groan as you feel your organs change, your pussy screaming for you to be mounted.

Suddenly you can feel your tail raise, and the absolutely humiliated you drops a large pile of manure. Just another sign you will be an animal soon.

    *** Game Over.  "Ummm... Lesbian Giraffes?!"  Male Human to Female Giraffe. ***

In that game you scored 0 out of a possible 0, in 13 turns.

Would you like to RESTART, RESTORE a saved game, QUIT, or UNDO the last command?

>restart
The End of the World: TF Series: Witches Coven, a prequel to the original End of the World Twine game. 

by The Loveable Wendigo.

An Interactive Fiction
Create Your Character

Press any key to continue ...

>[down]
It's time to choose what sex you were born as.  You'll be lucky to stay this the course of the game, and even luckier to end it as human.

Please choose a gender for your character.

>f
Thank you. We now begin...

Press any key to continue ...

>m
Ah well how to start.. well this is your head.  Yep, that's right, you.  And you've been living in this city for quite a while.  Of course, there's not much to say about you, as you already know, and are starting to wonder why you are saying all this to yourself in your head. 

Press any key to continue ...

>m
Welp, might as well give yourself a quick summary of the days events if you're gonna be crazy like this.  Hmmm lets think.. well nothing out of the ordinary happened, UNTIL like right now.  Because you chose to work out for once by jogging like a normal out of shape person through the city park, and got lost.  And then something decided to just shoot out of the sky, or appear out of nowhere or something else that makes someone whos still saying this in their head seem even crazier.

Press any key to continue ...

>m
Anyways, the second that dropped out of the sky you could hear stranges noises and cries throughout the city. Which is never a good sign.  Coupled with the horrible uneasy feeling you have had in your stomach since, well... to look at it positively it may have been nice that you got lost in the city park.

Okay, time to get some stuff done, like finding a way out so you can at least see what's happened.  You start at a determined pace again, weaving down the path you SWEAR you've been down before.  The bend up ahead is different though... something is casting flickering light against the nearby trees as you get closer and closer.

Press any key to continue ...

>m
City Park
The path along the park has seemed to come to a small clearing. On one side sits a bench with scattered yellow papers strewn across it. A still smoking crater, obviously made by some sort of falling anomaly, is present right behind it.  The anomaly appears to be some sort of chest or case with several doors, one of which is currently open to allow access to the storage compartment within. The open compartment has what appears to be... wooden sticks?  Or wands... seriously?  Seriously, freaking wands?  Welp, it has been a weird day.  Some bull ran through a china shop today down the road from your work.  Of course, when the cops showed up, they found a whole herd of cattle.  But you crocked that up to it just being the city.

Weird things happen in the city.

Eerie silence is all that can be heard this deep in the park, and the slight chill in the air makes you feel uneasy just to be here.

You can see Fulfill Your Destiny, a wand, a tree, a few bushes, and a streetlight here.

>restart
Are you sure you want to restart?

>y
The End of the World: TF Series: Witches Coven, a prequel to the original End of the World Twine game. 

by The Loveable Wendigo.

An Interactive Fiction
Create Your Character

Press any key to continue ...

>m
It's time to choose what sex you were born as.  You'll be lucky to stay this the course of the game, and even luckier to end it as human.

Please choose a gender for your character.

>m
Thank you. We now begin...

Press any key to continue ...

* * *

>examine wand
You see nothing special about the wand.

Do you pick up the wand?

* * *

>y
You pick up the wand, a strange power tingling down your arm as the end briefly glows.

**BAM**

Before your brain can even process what is happening, a massive explosion of magic happens right in front of you, knocking you to your back with the force.

"INTRUDER, LAY DOWN MY ARTIFACT" the sound, decibels above what any normal human could project, nearly blows your damn ears out.  Figuring she must mean the Wand, you throw it to the ground, raising your hands up after as if you were surrendering.

Press any key to continue ...

>[up]
"INTRUDER, LAY IT DOWN OR FACE MY WRATH" You have no idea how to react, so you do what you've always done best and curl into the fetal position.  The massive sound ceases, and the smoke clears, whisking off to nothingness. 

Press any key to continue ...

>[up]
Still shivering, you peek your eyes out from around your arm.  A woman stands there, clad in dark robes, her features beyond beautiful.

"What is your name, mortal?" the question flows of her lips like notes rippling on a harp. You stutter your name in response, hardly knowing what the hell is happening.

"You have my artifact, young one" she says. "I am the protector of this magical realm, the Mistress of the Dog.  I am one of several who rule this magical realm, among my fellow justicars The Mistress of the Elephant, the Bull, and the Zebra. I have come to despise my sisters though, as being their protector I am always watching over them.. and in the time I have guarded them they have grown restless and violent.

Today is the End Day, the day in which their hate for mankind is spilling over.  You do not know this but you are that which is Chosen, one who carries the Artifact."

**CRACK**

With a snap of her fingers, a box appears in your hands.  "Wha... what is this?" you ask in wonderment.

Press any key to continue ...

>[up]
With a kind smile, she answers "This is the Artifact, child.  It is your kinds only hope in saving your physical world from my sisters and their minions.  You must collect the wands of their covens, place them in the Artifact and then find the ancient device that will remove our world from yours.

"Where is it?!" you cry, beginning to get distressed about her extremely high expectations of you.

Shaking her head she responds "I do not know, none who hold a wand of power can know that".  Well. This is sounding kinda difficult.

Press any key to continue ...

>[up]
"OO! That reminds me!" she says, snapping her fingers again.  The wand you had previously thrown on the ground rises, slowly moving through the air towards you before coming to a stop and hovering a foot from your box.

"Take my wand, The Wand of The Dog, and place it in the box, sealing my magic.  Hurry now! There is not much time! You must find the other three and then dispose of them!" you nod, terrified at the prospect, but still snatch the wand out of the air and throw it in your box.

Looking up, the beautiful witch is smiling at you and fading away into nothingness...

Well, fuck guess you gotta save the world.

>e
(first opening Fulfill Your Destiny)

Park Entrance
The foreboding darkness of the city park looms here, swallowing up any that dare go inside.  Something seems off about it tonight, and not in a good way.

You can see Fulfill Your Destiny, a couple bushes, an entrance sign, a bent fence, and a flickering streetlight here.

Exits: north.

* * *

>n
15 Rogers Road
The foreboding darkness of the city park looms here, swallowing up any that dare go inside.  Something seems off about it tonight, and not in a good way.

Exits: south to Park Entrance, west, northwest, north and east.

>n
Lackluster Apartments
The crumbling building labeled "Lackluster Apartments" is only really used by the assorted methheads living in the area, and as a quick, albeit dangerous, shortcut between the back gate of the nearby Research building and the city park.

Exits: south to 15 Rogers Road and north.

>n
HK Research Group
The inner quarters of the firm may be locked, but the same old passable fences are there.  The high end company tried to repair the cut holes and kicked in chains the first few months... but the companies decision to build their structure right in the middle of one of the primary paths through the city was a dumb idea.  People may work there during the day... but it was the path it provided at night that made it popular.

Exits: south to Lackluster Apartments, east and north.

>n
Commercial Intersection
Quite a crossroads, Commercial Intersection is busy despite... current events.  A group of young women, obviously oblivious to everything but themselves, are striding towards the mall, probably intent on selling their parents money.  A massive parking lot of cars rides along the road, backup for the underground parking garage at the mall.  A group of people putting on a play are running about in scripted motion a little farther down from the young women, and a crowd of people are watching next to it.  Though a large amount of them seem to be paying attention to something happening right next to them.  You can't see what though.

You can see Gaggle Of Girls, Traveling Actors, and Crowd here.

Exits: south to HK Research Group, northeast, west and north.

>n
Mall Entrance
The Mall Entrance is a mostly fountain, with spiraling and shooting archs of water all over, an impressive sign over them stating its the entrance to St Peters Mall.  It certainly stands out.

Exits: south to Commercial Intersection and north.

>n
Jupiter Hall
All around you the mall bustles with people.  A certain uneasiness is in the air though, something isn't right.   You may want to check that out... or you could go to the food court and chow down on some delicious fast food.  Or, if you want to go shopping, there's assorted outlets throughout the store.

Exits: south to Mall Entrance, west and north.

>s
Mall Entrance
The Mall Entrance is a mostly fountain, with spiraling and shooting archs of water all over, an impressive sign over them stating its the entrance to St Peters Mall.  It certainly stands out.

Exits: south to Commercial Intersection and north to Jupiter Hall.

>s
Commercial Intersection
Quite a crossroads, Commercial Intersection is busy despite... current events.  A group of young women, obviously oblivious to everything but themselves, are striding towards the mall, probably intent on selling their parents money.  A massive parking lot of cars rides along the road, backup for the underground parking garage at the mall.  A group of people putting on a play are running about in scripted motion a little farther down from the young women, and a crowd of people are watching next to it.  Though a large amount of them seem to be paying attention to something happening right next to them.  You can't see what though.

You can see Gaggle Of Girls, Traveling Actors, and Crowd here.

Exits: south to HK Research Group, northeast, west and north to Mall Entrance.

>ne
Haverton Bridge
The Haverton Bridge juts off at an awkward angle, the addition of the uptown district obvious as a later one.  You can see a few people walking across it, drunk as shit.  The uptown district is known for one thing... its bars.  Well, two things.  The second is it's population.  All douchebags with orange spray tans, and hot chicks with a stick up their ass.

Exits: southwest to Commercial Intersection and northeast.

>ne
Party Avenue
Party. Freaking. Avenue.  You remember when you were 21 and used to be here every night.  With how expensive the bars are here, thats probably why you're scrambling for money now.  Looking down the row you can see all the locales you used to consume alcohol in.  It looks like not much has changed.

Exits: southwest to Haverton Bridge, east and north.

>n
Upper Class Arts
Upper Class Arts is this gimicky thing for rich couples to drink wine and make paintings Bob Ross style.  Of course, they're drunk and not artists so they typically turn out terrible, but they're rich, so they aren't worried about what they spend their money on.

Exits: south to Party Avenue and northeast.

>ne
The Long John
You enter The Long John, a nearby bar that's usually packed this time of the day.  As you enter, you can see a crowd near bar.  Wait a sec, they're all wearing ski masks..

Exits: southwest to Upper Class Arts and north.

* * *

>e
(first opening Fulfill Your Destiny)

Park Entrance
The foreboding darkness of the city park looms here, swallowing up any that dare go inside.  Something seems off about it tonight, and not in a good way.

You can see Fulfill Your Destiny, a couple bushes, an entrance sign, a bent fence, and a flickering streetlight here.

Exits: north.

I beg your pardon?

>n
15 Rogers Road
The foreboding darkness of the city park looms here, swallowing up any that dare go inside.  Something seems off about it tonight, and not in a good way.

Exits: south to Park Entrance, west, northwest, north and east.

* * *

>n
Mall Entrance
The Mall Entrance is a mostly fountain, with spiraling and shooting archs of water all over, an impressive sign over them stating its the entrance to St Peters Mall.  It certainly stands out.

Exits: south to Commercial Intersection and north.

>s
Commercial Intersection
Quite a crossroads, Commercial Intersection is busy despite... current events.  A group of young women, obviously oblivious to everything but themselves, are striding towards the mall, probably intent on selling their parents money.  A massive parking lot of cars rides along the road, backup for the underground parking garage at the mall.  A group of people putting on a play are running about in scripted motion a little farther down from the young women, and a crowd of people are watching next to it.  Though a large amount of them seem to be paying attention to something happening right next to them.  You can't see what though.

You can see Gaggle Of Girls, Traveling Actors, and Crowd here.

Exits: south to HK Research Group, northeast, west and north to Mall Entrance.

* * *

>ne
Party Avenue
Party. Freaking. Avenue.  You remember when you were 21 and used to be here every night.  With how expensive the bars are here, thats probably why you're scrambling for money now.  Looking down the row you can see all the locales you used to consume alcohol in.  It looks like not much has changed.

Exits: southwest to Haverton Bridge, east and north.

>e
Illus Design Corp
Illus Design sits here, one of the longest standing companies in the city.  They are very down to earth despite their incredible looking locale that spirals into the sky.  There's a window to the basement you can see on the right side of the building, and it appears already slightly open.  Inside you can see a amateur sign next to a closet door that says "Supply Shop Open".  Whats even more interesting is the obvious trip wire through the window, showing you this is more then it appears. And definitely a trap.

You can see Supply Shop (in which is Possible Trip Wire) here.

Exits: west to Party Avenue and northeast.

>ne
Walter Haven
Walter Havens fountains lead to a beautifully lit garden area.  Behind the trees lining the garden, you can see a door into a wall of stone.  It's unmarked, but the nearby tree has that Weird Logo you've been seeing.

Exits: east, southwest to Illus Design Corp and north.

>n
Side Pass
The garden curls around into a little side road/path.  Its easy to get around Uptown with all these winding paths through gardens and other city beautification projects.  Much better then the business district, thats for sure.

Exits: south to Walter Haven, southwest and northeast.

* * *

>n
You can't go that way.

>e
(first opening Fulfill Your Destiny)

Park Entrance
The foreboding darkness of the city park looms here, swallowing up any that dare go inside.  Something seems off about it tonight, and not in a good way.

You can see Fulfill Your Destiny, a couple bushes, an entrance sign, a bent fence, and a flickering streetlight here.

Exits: north.

* * *

>ne
Haverton Bridge
The Haverton Bridge juts off at an awkward angle, the addition of the uptown district obvious as a later one.  You can see a few people walking across it, drunk as shit.  The uptown district is known for one thing... its bars.  Well, two things.  The second is it's population.  All douchebags with orange spray tans, and hot chicks with a stick up their ass.

Exits: southwest to Commercial Intersection and northeast.

* * *

>n
Upper Class Arts
Upper Class Arts is this gimicky thing for rich couples to drink wine and make paintings Bob Ross style.  Of course, they're drunk and not artists so they typically turn out terrible, but they're rich, so they aren't worried about what they spend their money on.

Exits: south to Party Avenue and northeast.

>ne
The Long John
You enter The Long John, a nearby bar that's usually packed this time of the day.  As you enter, you can see a crowd near bar.  Wait a sec, they're all wearing ski masks..

Exits: southwest to Upper Class Arts and north.

One turns to seee you, shit!

"HEY STOP THERE!" Plants shoot out of the ground, holding your feet to the ground.  Suddenly the crowd starts thinning in front of you, disappearing into nonexistence until just one remains. Well one, and what the illusions were looking at.. A poor woman.  The short haired girl has dyed hair, the color of blue, and is crying with all four of her limbs held to the ground with vines as well. The robed figure pulls back her hood to reveal... some sort of deer woman? What the hell is this?

Press any key to continue ...

>[down]
The deer woman opens her muzzle and starts her speech, "This young woman thought she could hit one of my friends that was crossing the road and keep driving.  "Jennifer" here thinks she is above us.  But she's going to be the perfect replacement, and very much one of us.  And I think you'll enjoy joining her.. she'll need a mate to give her a fawn to raise.

With this statement the girl lets out a loud sob, struggling to escape the vines with no hope. "Please I'll do anything I don't want to be an animal" she begs the witch, who just ignores her. 

Press any key to continue ...

>[down]
Suddenly the vines extend, grabbing onto your arms and guiding you through the air til you are on all fours behind the poor girl.  Shes trying to crane her head to see what is happening, but a vine sprouts out from underneath her and turns her head forward. Oh crap... this isn't good.
The sound of a car outside passing comes as a unexpected savior.  The witch freezes in the light beams as it drives past.  This is your chance to escape, or try to just "ride" this out.  Do you want to escape?

>y
You refuse to, breaking free of the magical vines and running through the back door.

As you sprint across the alley to the woods behind the building you find yourself... Growing? No! You're lifting.. Levitating into the air. "Fuck!" You yell, unable to go anywhere.

Against your will, you start to turn in the air, revealing the witch and bound Jennifer standing behind you. The witch has her wand pointed at you, its magic holding you in the air.

"You just had to run. You couldn't take my generous gift" her spiteful taunt making you feel sick. "Well lets give you your punishment.."

*POPPP*

All your clothes are gone. You try to cover your shame but you still cant control your limbs. You'll have to settle for just staring daggers at the witch. Then you feel your penis twitch. Then twitch again. "What are you doing?!" You yell, weird feelings flying through your body. The witch smiles and waves her arm, forcing your head to look down.

Press any key to continue ...

>[down]
Your cock is fully erect, it standing like a sideways flag pole out of your nethers. But its twitching, and darkening. You watch as the head of it disappears into its length, the feeling of warmth spreading from it. You can only gasp as the skin behind it bubbles and expands like a bloated... Breast? The breast skin holding your dick changes to the same color as it, your dick shrinking slightly in size as your balls disappear in the mammary mass. "Whyyyy?" Your ragged cry escapes your mouth at the sight of what you thought was still your dick multiplying into 3 more, the realization that you now have a few small teets sinking in. Brown fur erupts from the outside of your jiggling breasts tissue and starts to cover your widening ass. The area behind your utter is stirring, and from what you can feel growing warmer and wetter. "ohhhhhh" you moan as you can feel a tail wiggling above your ass, the warm feeling right below it and moving to meet with your butt hole.

Suddenly you drop from the sky, landing nimbly on your hardening fingers. "Get her, Jennifer" the command from the witch causing you to jump, you had forgotten they were there.

*SNIFF*

the warmth behind you is being nuzzled by something, and its making you feel weird. Looking behind, you have just enough time to see the antlers of a stag before his tongue licks your warmth, sending a shockwave of pleasure through you.

Press any key to continue ...

>[down]
Its then that you realize what's happening to you. "Pleaze don't make me the doe" you beg, "ill do whatever you want.. Please dooOOOOOOHH" The stag jumps on top of you, thrusting frustratingly at your doe pussy. You bleat, trying to get out from underneath him. His dick finally hits the target though.. But its your little doe asshole. He plows into it, causing you to cry out in a deerlike whimper. He starts fucking you like mad, the feeling of being mated with a new feeling for you. His balls keep slapping against your plump doe teets as one of his thrusts pull out far enough to plop out of your asshole, the next finding your vagina.

He starts going to town again, what you can only assume as a shit covered deer dick pounding your pussy. You keep crying out in fear but you can feel something stirring inside of you. "Nooooooo" the bleat the closest to a human sound you can make as you piss yourself from the pleasurable humiliation. The stag thrusts all the way in, your eyes popping out of your head as the sudden move pushes you to cum on his hilted cock. You can feel his seed pumping inside of you, and you know you've been claimed. You bleat as he pulls out,exhausted, a squelching sound of your still wet pussy spewing out some of his cum. But its still too much, you know you're pregnant.

The witch laughs at you, turning to leave you there to get raped by former Jennifer some more. "im going to leave you with your mind intact asshole," her last words to you putting terror into your heart, "i hope you enjoy deer dicks pounding you for the rest of your life, because that's all your gonna get.".

    *** Game Over.  "DOH!!!"  Male Human to Doe. ***

In that game you scored 0 out of a possible 0, in 11 turns.

Would you like to RESTART, RESTORE a saved game, QUIT, or UNDO the last command?